		第七课 仔细阅读4
提高练习：
berrowed 			借来的
It's pretty clear....  		很明显
sensible  			合理的
upon graduation	 		一毕业就
multiplying  			变多
maintenance  			维护、费用
absolutely  			完全地
public dime  			公共资金
a low wage  			低工资
elementary school  		基础学校
in exchange for  		作为....交换
desirable  			不值得拥有
irrational way 			不合理的方式
unsustainable  			不能继续
strive for  			为之奋斗
bear costs  			承受费用
embody  			显现
		
错题原因：
1、正确选项：文中说到，如果让纳税人去承担学生的学费，纳税人有权使用自己的这笔钱，比如让学生学习对纳税人有利的课程、专业，选项说的：选择专业的时候选择社会尤其需要的。乍一看这两个没啥关系，仔细分析可得，学生选择了社会需要的专业，这个专业就一定会给纳税人好处。细思极恐！！！！
错误选项：我认为纳税人要求学生去学自己想让他学的专业，这件事就算纳税人参与到了学校的管理中。以偏概全。
2、正确选项：文中说你所受的教育值多少钱就是从平均薪资反映出来。
错误选项：文中在谈论工作时说了学生能力被低估，但没说是雇主低估学生能力。
3、正确选项：全文都在谈论学生学费谁承担的问题。最后得出结论，学生自己承担自己的学费。
错误选项：文中的重点不是说大学教育的好处不是存在争议。还有最重要的是：Fund：承担

		第五课 课后作业
less conspicuous	不那么明显
underway 		正在发生
human beings live	人们的生活方式
enormous		巨大的
impact on sth		在某事上的巨大影响
biodiversity		生物多样性
ultimate invasive speciew	最大的入侵物种
in what sense		什么原因
territory		领地
displace		替换/背井离乡
born to conquer		生来就是征服
in turn 		随之
in what way		什么方式
this is especially so		尤其如此
desperately		极度地/拼命地
slash forest		砍伐森林
underscore		强调
one thing that's clear is that …… 	显而易见的一件事是
over the last couple of hundred years   接下来的几百年

International government's inaction	国际政府的无所作为
take initiatives in	主动出击
proactive		主动出击
in accodance with	与……一致
contribute to 		造成
Companies like Toyota and Wal-Mart are not committing to environmental goals out of the goodness of their hearts.	are not out of 不是出于这样的好心
realisation		意识
economic footprints	经济影响
fit well together	搭配
launched		启动
initiative		计划
a sense of responsibilityh	责任感
why --- argue		原因
lack the incentive	没有动力
going beyond compliance	超过这些规定
saves cost		节约成本
aspirational goals	有抱负的目标
do much better --- outperforming	更好
		

		第八课 仔细阅读
conspicuous		显而易见的
depression		n 沮丧，忧愁，抑郁症
relates			v 叙述，讲述
cultivation		n 培养，耕种
ships on the coast of	海岸上的船只
artificial imitation	人仿造
serve as 		担任...，充当...，起...的作用
concentrate on		集中精力
moral advantages of sharing	分享的道德优势
visibility		n 可见性
citation		n 引用
improved		vt 改善
wood density		木材密度
range from 		从...到...变动，从...到...范围
biomass			生物量
forester		n林木工人
grades of timber	木材等级
Antarctica		南极
Arctic			北极
recommendatino to	建议
recommendation		推荐
ocean sanctuaries	海洋保护区
greepeace		绿色和平
be calling for		被要求
halt to fishing		停止捕鱼
huge tracts		大片
vast area		广大的地区
away from == get out of	避开
peninsula sanctuary	半岛的避难所
organisation sought	组织寻求
vulnerabilty		n 易损性
coordinator		协调者
policy discussions	政策讨论
expertise		专业知识
too consipcuous to be observed	太显眼观察不到
too consipcuous to not be observed	太显眼了不可能观察不到
在阅读理解中看到more most就要想到是比较关系
citation		引用
repository		n 贮藏室，仓库，知识库
in the vicinity of	在……附近
groundings		因故障停船不走了
amid			prep 在什么过程中，在……氛围中
considered for sth.	考虑某事
responsible player	负责任的参与
not until		直到……才
not expected until later预计晚些时候
not A but B		不做A而做B
unprecedented		以前没有现在有
serious			不知道有没有
for what purpose	什么目的
keep sb. from sth.	阻止某人做某事
sense of responsibility	责任感
cordinator		协调
initiator		发起者


		第九课 仔细阅读
survive sth.		经过某事后存活下来
Rarely has there been b better example...
			谓语has提前，example的意思是说明
privilege		特权，荣幸
behave			表现
ideologies		意识形态
turn sth into sth	将A转化为B
filter			过滤
know them personally	你的朋友
rather			宁可，宁愿，准确地说
in your presence	在你前面
distinctive identity	特殊的身份
don't necessarily == not suggest	不一定
...,that's why...	that前面是原因，why后面是形成的结果
in line with		符合
go beyond		超过
the way			可以做连词，表示按照
is there anything you consider a burden...
			anything 应该在consider之后
is a settle way		一个确定的方法
refinement		改进，改善
idols' behaviors	偶像的行为
a find expression in B	A表现在B中
How come...		为什么
What is propose...	建议
no matter what		无论什么

mediate			影响
ambitious		物：艰难的，人：雄心
alleviate		减轻
at once			同时
sheltering		避护
treks			长途
appear to		似乎
nine out of 30		9/30
discrepancy		差异
startlingly		惊人的
apparent		明显的
better-off children	富裕孩子
tap up			求助
tap into		利用
probing			探索
outing			短途旅游
good case		好的理由
ingenuity		创造
pupils			小学生
justified		合乎情理
pool			n.池，v.共用
little more than 	仅仅是
feel guilt		感到内疚
guidance says ....,and that(guidance says) ...
syllabus		教学大纲
exempt from...		免除...
glamotous		奢华的
bring together		团结
left behind		留下遗憾
keep sb. from sth.	阻止某人做某事
board and lodging	食宿费
suggest	do		暗示


		第九课 仔细阅读 课后作业
formally		正式地
taken something for granted	把某事想当然
leaving A for B 	把A留给B
implication for...	对...的影响
navigated		浏览
owned by		被谁拥有
subtle topic		微妙的主题
inability		没能力
potential		a.潜在的，n.可能性
anniversary		每年
revolutionize		彻底改变
regularly		adv.定期地
built-in sensors	内置的传感器
beyond			除...之外
revealing		显示
population-wide patterns	整个人口模式
indicate		显示
some form		某种形式
unusual			不寻常
intervention		n.介入，妨碍，调停
with undergraduate participants		大学生参与
insights into		深刻的理解
by no mean == not	不
more often than not	往往，通常
overshadowed		不重要
overstated		夸大
less obvious		不那么明显
questionnaire		问卷
pin down == identify	明确
cope with		应对
obnormal		异常
rigorous		严谨
targeted towards	以...为目标
less likely		不太可能
clinical trial		临床试验
examined 		adj.检查过的 v.检查，调查
consistent		常见
likability		喜欢
modest effect		一定的影响
at least		至少
academic outcomes	学习成果
associate dean		副院长
not as liked by		不被喜欢
so-called		所谓的
non-cognitive		非认知的
incorporates		组成公司
self-regulatory		自动调节
determinants		决定因素
comprehensive		adj.综合的，广泛的 n.综合学校
all-round approach	全面的方法


		阅法三章 第九课
take effective/drastic measures to do		采取有效/严厉措施
restore the confidence	恢复信心
the chair of/chair(动词)+组织机构		...的主席
the architect of an idea/event/institution	想法/事件/组织的发起者
groundbreaking work	突破性的工作
monetary and fiscal	货币和财政
one's suffering 	某人的苦难
to aggravate the problem/biases			加剧问题/偏见
the incoming/outgoing+职位			即将就任/即将卸任的...
the formulate poicies/laws			制定政策/法律
prior to		在...之前
instead of...		后面是否定的
instead...		后面是肯定的，意思为：转而
crucial to		至关重要
opening			建筑物开幕式
a multi-disciplinary	多学科
some of the open-ended questions		没有确定答案的问题
raised			提出
renowned		著名
be cautious about sth.	对某事比较谨慎
industrialisation	工业化
director		主管
B as a result of A	B的后果是A
philosophy		哲学
psychology		心理学
come about		到来
take seriously		重视
uncritical		不加批判的
undo			消除
over-amplify		过分夸大
A same adj as B		A和B一样adj
keep A control		处于A的控制权下
		
amateurs		业余人员
A resulting in B 	A导致B
pilot			飞行员
cold comfort		不起作用
injury to sb.		某人受伤
on top of 		除了...
tragic			悲剧的
cast a long shadow	蒙长久的阴影
took hold		产生影响
streak			个性
orbit			轨道
briefer ventures	时间更短的冒险
deosits			订金
be dogged		困扰
delay			延误
A entails B 		A必然带来/要求B
present a danger/challenge/problem	带来危险/挑战/问题
in short		总之
academic community	学术界
early on		老早
be inclined to do 	倾向于
find sb. in the position发现某人处于某种状态中
founder			创始人
last resort		最后可依赖的人或事
be well suited to sth/doing sth.	非常适合做某事
a keen understading	敏锐的理解
buy into sth.		信从
crew			船员
suspend			暂停
add A to B 		把A添加到B
playground		乐园
amend			修订
transcend		超越
pioneer			开创
entail			涉及到、导致
hard-won		艰难
carry on		继续
face/meet/tackle the chanllenge			面对/遇到/应对挑战
cognitive science/development/functioning	认知科学/发展/功能
expand the knowledge/understanding/program	拓展知识/理解/项目
federal reserve/government/agency/court		联邦储备/政府/机构/法庭
financial/economic/credit/food crisis		金融/经济/信贷/粮食危机
to address + 问题				处理/应对
inflation and deflation				通货膨胀和通货紧缩
the former/latter				前者/后者
take on the role job				承担角色/工作



		阅法三章 第九课 课后作业
right person		合适的人
be expected to		有望做某事，期望做某事
no stretchto do（think）做某事不用思考
last resort		最后的手段
holding up		支撑
in the form of 		以...的形式
previously		先前的
principal architects	主要的创造着
a kind of		一种，一类；某种
prophetess		预言家
meltdown		灾难
derail			v.(火车)出轨	
fragile recovery	脆弱的复苏
keep			敏锐的
appreciation		（鉴别，感谢），欣赏
imperfection		不完美
be inclined to		倾向于
neglect			忽视
well-off		富裕的，顺利的
long-term		长期的
opposite		对立的
either way		不管怎样
ending the stimulus	后面的刺激
buy into		完全相信
argument		论证
all long		自始至终
walk a fine line	小心行事
back down to earth	回到现实
leave st. alone		不管某人
buy into ...		完全相信
past			以前的
slack			a.松弛的,adv.松散地,n.懈怠
below			低于
stabilizes		稳定
includive and robust	包容性和健壮性
logical			逻辑性
listener		倾听着
hostility		异议
take on			承担
deflate			消除
monetaryt program	货币计划
portray			描绘
possesses		拥有
persuasive power	说服能力
most powerful		权力最大
defining challenge	及其重要的
not merely		不只是
fundamental		基本
public figure		公众任务
to do + 宾补
farther apart		之间的距离
so what factors,at the comunity level,do predict if ...		什么因素预言是否...
what explains,for instance,why the A...				什么样的解释，为什么...
the fortunes		命运
lift			提升
least			最不
move up			提升，上升
middle class		中产阶级
riligiosity		宗教信仰
get ahead		vt.使得,n.生殖,vi.成为
relative predictive	相对预测
rags-to-riches		穷人到富人
malicious		恶毒的
interpreted		理解
the fortunes		命运
strongly correlated with..					与...密切相关

	
			仔细阅读10
haze			雾霾
guidelines		标准
what is more important	逻辑连接语，更重要的是
smog			雾霾
系动词+看搭配
airborn particles	大气粉尘
hare yet to do sth.	还没来得及做某事
locating sth.		找到
be locate in		坐落于
sb. determine to do sth.某人决定去做...
determine sth.		确定，查明
A determine B		A影响B
opting to do sth.	选择做某事
opting for sth.		选择做某事
opt out			退出
opt in/on		选择参加
switching to sth.	转移
switch with 		交换	
brakes			刹车
tyres			轮胎
motor vehicle		汽车
alternate		a.交流，轮流
crown			v.王冠，加冕
generated		v.产生，制造
merged			v.合并，融合
miniatures		n.缩影
prematurely		adv.过早地
synonymous		v.相同的
kidney			肾
mulfunction		v.发生故障 n.故障
have anything to do with it 	和她有任何关系
caught sb. unwares	使某人措手不及
havoc			灾难
drill			演习
It's the mother		孕育了
will undoubtedly	毫无疑问
unleash			解除束缚
what if ... A ...	A出现怎么办
converge		汇合
boundary		交界处
beneath			在下面
shake			震惊
metropolitan		大都市
havoc			灾难
scenario		n.方案，场景
avert			避免
rehearsal		n.排练，演习
inform disaster		影响
if			是否
after math		后果
immenent		立即到眼前
in case of		在...情况下
最难题型：答非所问
remains to be seen	拭目以待
never to early		不会太久
haunting		困扰
magical creature	神奇生物
golden eagles		金雕
population		人：人口，动物：种群
mainland		大陆
complete with 		配备
helicopter		直升机
sharp shooter		神枪手
philosophy		理念，哲学
bounds about		蹦蹦跳跳
vaccinate		vi.接种疫苗
keep a pulse		把脉
tagging			贴标签
numbers			数量
dwell in		住哪
dwell on		详述
chaos			n.混乱
configuration		n.构造，配置	
declared		v.宣布
dedicated		v.致力于
fierce			a.激励的
hinder			v.阻碍
mammal			n.哺乳，动物
predator		捕食者
remove			v.搬走，免职
tempt			n.劝说
underlying		a....的原因，根本地
re-emerged		东山再起
pioneering		n.先驱
masterpiece		杰作
under attack		受到攻击
occasionally		偶尔
B attributed to A	A是B的原因
insight into		顿悟
long voyage		很长一段旅程
unfilled		空的
ahead of the curve 	走在前端
medical cart		医疗车
retrieve records	检查记录
implement		vt.实施，n.工具
fairly minimal		最少
serve as		视为
intermediary		中间的
hang out		出去玩
appearance affect	外观的影响
teddy bear		泰迪熊
cute 			可爱
wheelchair		轮椅
scary			可怕
courses of treatment	疗程
















